WWWWWWWWWWWWWWWWWWWWWWWWWW
W00000000000000H000000000W
W00000000E000000000000000W
W00000000000000000P000000W
W000000000000000000000000W
WWWWWWWWWWWWWWWWWWWWWWWWWW
