WWWWWWWWWWWWWWWWWWWWWWWWWW
W00000000000000H000000000W
W00000000E000000000000000W
W00000000000000000A000000W
W000000000000000000000000W
W000000000000000000000000W
W000000000000000K00000000W
W000000000000000000000000W
W00000000A000000000000000W
W000000000A00000000000000W
W00000000K000000000000000W
W0000000000000K0000000000W
W000000000000000000000000W
W000000000000000000000000W
W000000000000000000000000W
W000000000000000000000000W
W000000000000000000000000W
W000000000000000000000000W
WWWWWWWWWWWWWWWWWWWWWWWWWW